###_#########
#___________#
#_##_______##
#_##________#
#_###########
#_###########
#________####
##_###_######
##_###_######
##_###_######
##_###_######
##_###_######
##_###_######
##_###_######
##_###_######
##_###_######
##_###_######
######_######
##_###_######
#___________#
#_###########
#_###########
#_###########
#___________#
######_######
######_######
######_######
#___________#
#_###########
#_###########
#_###########
#_###########
#_###########
